            .   .    
            | X |    
.___.___.___.   .___.
|   | T             |
.   .   .   .___.   .
|       |       | M |
.   .___.   .   .   .
|           |       |
.   .___.___.   .   .
|           |   |   |
.   .   .   .___.   .
|                   |
.___.___.___.___.___.