.___.___.___.    
|     M     |   
.   .___.   .___.
|       |     X  
.   .___.   .___.
|     T     |    
.___.___.___.    