.___.___.___.    
|     M     |    
.   .___.   .___.
|     T       X  
.   .   .   .___.
|   |       |    
.___.   .   .    
|           |    
.___.___.___.    